1 13 31
-------------------------------
-p     -- -  1 - 2 -  - - -   -
- - - --- - ----- - - ------- -
-  x-  s  ---  -  1   - 2 - - -
- - - - - --- - ----- - - - ---
-b         x --  -  -   1     -
- - - - - - - - - --- --- - - -
--  -      -  -      -   f    -
- - - - --- - - ----- - - - - -
--    --  -       -           -
- --- - - - - - --- - - - - - -
-           -   -  -          -
-------------------------------
